 50 words to get started with Spanish / 50 palabras para empezar con el espanol
the =  el la los las
de = estar
to = a
of = de
and = y
they = ellos ellas
we = nosotros
say = decir
her = su ella
she = ella
just = justo
time = el tiempo , la hora
no = no 
him = el lo le
know = saber
take = tomar
after = despues de
use = usar el uso
two = dos
how = como
our = nuestro
a = un una
people = la gente
work = trabajar
in = en 
an = un / una
into = en , a
first = primero
well = bien
your = tu
my = mi
with = con
have - lener
one = un , el uno
good = bueno
way = elcamino
any = alguno/ alguna
some = un poco
even = aun
it = es, lo/la
for = para/ por
not = no
on = en, sobre
he = el
that = que, ese/ esa /eso
as = como
you = tu /uste
do = hacer
at = en
this = este/esta
but= pero
his = su
by = per ,de
there = ahi 
their = su, sus
wat = que
so = tan 
up = arriba
out = fuera
if = si
about = sobre
whe = quien
get= abtener
which = cual
go = ir
me = me
when = cuando
make = hacer crear
can = poder
like = qustar
could = podria
them = los/ las
see = ver
year = el ano
other = otra
than = que
then = entoces
now = ahora
look = mira
only = solo
mos = la mayoria
its = su
over= arriba de
think pensar
also = tambien
way = elcamino
even= aun
new = nuevo
want = querer
because = porquea
all = todo
these = estos/estas
give = dar
day = el dia
come = venir
us = nos 
